11111111111111
10010000000001
10100000000001
110000N0000001
10000000000001
10000100000001
10000100000001
10000100000001
11111111111111